1111111111111111111
10000000000C0100001
100000C000000111001
11111100000C00000P1
10000000011111000E1
1111111111111111111