1111111111111111111
10000000000C0100001
100000C000000111001
11111100000C0000001
1000000001111100PE1
1111111111111111111