1111111111111111111
1P00000000000100001
100000C000000111001
1111110000000000001
10000000011111000E1
1111111111111111111